6:

פועל	שורש	בניין	זמן	גוף
הצטמק	צ.מ.ק	התפעל	עבר	נסתר
הצטברו	צ.ב.ר	התפעל	עבר	נסתרים
תסתבן	ס.ב.נ	התפעל	עתיד	נוכח
נזדמנו	ז.מ.נ	התפעל	עבר	נסתרים

חלק ב

פועל	שורש	בניין
התנדבנו	נ.ד.ב	התפעל
מרמז	ר.מ.ז	פיעל
צולמנו	צ.ל.מ	פועל
משתלם	ש.ל.מ	התפעל
מזדקפת	ז.ק.פ	התפעל
מטפלים	ט.פ.ל	פיעל
מסמנות	ס.מ.נ	פיעל
מזגו 	מ.ז.ג	פיעל
מטופלים	ט.פ.ל	פועל
להתרגז	ר.ג.ז
קצרו	ק.צ.ר	פועל
תבלו	ת.ב.ל	פיעל
מפוסקים	פ.ס.ק 	פועל
הצטלמתי	צ.ל.מ	התפעל
תחדשו	ח.ד.ש	פיעל
הצטדקו	צ.ד.ק	התפעל
מיתנו	מ.ת.נ	פיעל
התמם	ת.מ.מ	התפעל
